                           NO textures/simonkraft/palestine7.xpm 
                        SO textures/simonkraft/palestine5.xpm
WE textures/simonkraft/palestine12.xpm
EA textures/simonkraft/palestine19.xpm


                   F   109,155,115

C 220,220,220

111111111111111111111111111111111111111111111111
100000000000000000000000000000000000000000000001
1000011111111011111111111111111110111D1111110101
100000000001100000000000001000000000000000000101
100011111101111111011111101111111011111111011111
100000000000100000000000000000000000100000000001
101111111111101111111111101111111101101111111101
101000000000000000000001000000000000100000000101
101011111101111101111101100000110111101111111101
101010000001000001000001000E00010000100000000101
1010111011111111011111011000000111D1101111110101
101000000000000100000001000100000000000001000001
11110111111110110111D111101101111111111101111111
100000000001000000000000000000000000000001000001
101111101111101111111111111111111011111101101101
101000000000000000000000000000000000000001001001
10101111111110111110111D111101111101111101111101
101000000001000001000001000000000100000000000001
101111111101111101111101111101111111101111111101
100000000100000000000000000100000000000000000001
111111111111111111111111111111111111111111111111

